11111
1C0P1
1C0E1
1C001
11111

