11111
10001
1C0E1
10P11
11111

