11111
1CC01
1C0E1
1CP01
11111

