11111
1C101
101E1
10P01
11111

