11111
1C101
10101
10P01
11111

