11111
1C101
111E1
10P11
11111

