11111
1C1P1
1C1E1
1C001
11111

