11111111111111111111111111111111111111111
1000000P000000000E0000000C00000C000000001
11111111111111111111111111111111111111111