111111111111111111111111111111111111111111111111111111111111111111111111111111111111111111111
1000000000000000111111111111111111111111111111111110000000000000000000C0000000000000000000001
100000000000000000000000000000000000000011111111111111111111111111111111111111000000000000001
111111111111111111111111111111111000000P00000000000000000000000000000000000000000000000000001
10000000000000000000000000000000E000000011111111111111111100000000000000000000000000000000001
111111111111111111111111111111111111111111111111111111111111111111111111111111111111111111111