111111111
1C1010101
1C1110101
1C1E10101
1P0C00101
111111111
